#################################
#...............@...............#
#.....##.................##.....#
#.....##.....#.....#.....##.....#
#............#.....#............#
#.....##.....#.....#.....##.....#
#.....##.....#.....#.....##.....#
#............#.....#............#
#.....##.....#.....#.....##.....#
#.....##.....#.....#.....##.....#
#............#.....#............#
#.....##.....#.....#.....##.....#
#.....##.....#.....#.....##.....#
#............#.....#............#
#...............................#
###.############.############.###
#.......#...............#.......#
#..T....#.......K.......#....T..#
#.......#...............#.......#
#################################
